XX  XXX  X X X XXXXXXXXXXXXXXX
X X X X   X X X
X X X    X X X XXXXXXXXXXXXXXX
X X X     X X X
X X X    XXXXXXXXXXXXXXXXXXXXX
X X X
X X X    XXXXXXXXXXXXXXXXXXXXX
X X X X
XX  XXX  XXXXXXXXXXXXXXXXXXXXX
                  XXXXXX
     XXXXXXXXXXXX  XXXX XXX
                  XXXXXXX  X
 XXXXXXXXXXXXXXXX XXXXXXXXX
                   XXXXX
 XXXXXXXXXXXXXXXXXXX

     XXXXXXXXX
